第十二課

試験

前文

今日は試験です。試験問題には「聴解」、「文字・語彙」、「読解・文法」の三つのセクションがあります。それぞれのセクションには五つの大きな問題があります。大きな問題にはいくつかのちいさいなもんだいがあります。それぞれの問題には、四つの選択肢があります。正しい答えは一つだけですから、二つ選んではいけません。書き間違ったところは書き直してはいいですが、書き直す時に、前の答えを消しゴムできれいに消しなくてはいけません。開始のベルが鳴る前に、先生はこのように説明しました。本当に難しくて厳しい試験です、しかし、みんなは一生懸命頑張ります。


会話

先生：みなさん、予鈴が鳴りましたから席に着いてください。
学生：はい。
先生：今から問題用紙と解答用紙を配ります。
学生：問題は多いですね、今すぐ書き始めてもいいですか。
先生：いいえ、まだ始めてはいけません。試験開始の合図があるまで問題用紙を開けないでください。これから注意事項を言いますから、よく聞いてください。一、最初に名前を正しく書いてください。二、必ず鉛筆を使ってください。三、試験中、他の人と話をしてはいけません。四、辞書や教科書などを見てはいけません。五、カンニングをしてはいけません。カンニングをした場合、試験の資格を取り消します。質問はありますか。はい、どうぞ。
学生：答え方はよくわかりませんから、教えて下さいませんか。
先生：はい、これから答え方が説明しますから、よく聞いてください。試験問題には「聴解」、「文字・語彙」、「読解・文法」の三つのセクションがあります。それぞれの問題には、五つの大きな問題があります。大きな問題が問題には幾つかの小さいな問題があります。答えはすべて解答用紙に書いてください。
学生：それぞれの問題には、四つの選択肢がありますが、二つ選んでもいいですか。
先生：二つ選んではいけません。選択肢が四つですが、正しいものは一つだけですから、一つだけ選んで、まるをつけてください。また、その解答欄にマークしてください。
学生：問題用紙を出さなくてもいいですか。
先生：いいえ、問題用紙も出さなくではいけません。問題用紙持ち帰ることはできません。解答用紙と一緒に出してください。問題用紙を出さない人は、採点しません。
学生：ボールペンや万年筆で書いてもいいですか。
先生：いいえ、ボールペンや万年筆で書かないでください。必ず鉛筆を使ってください。
学生：途中、質問してもいいですか。
先生：印刷がはっきりしていないところは質問してもいいです。その時は手を上げて小さい声で聞いてください。
学生：聴解試験の時は、メモを取ってもいいですか。
先生：はい、メモを取ってもいいですが、聞いての時間は長くないですから、よく考えながら聞いてください。
学生：書き間違ったところは書き直してもいいでしか。
先生：はい、書き直してもいいです。しかし、書き直す時は、前の答えを消しゴムできれいに消していください。
学生：答案が汚くなった場合はどうしますか。
先生：試験の結果はコンピューターで統計しますから。答案が汚くなった場合は採点ができません。ですから、気をつけてください。
学生：時間は延ばすことはできますか。
先生：時間は延ばすことはできません。必ず時間を守ってください。質問はもうありませんか。では、ちょうど開始のベルは鳴りましたから書き始めてください。

単語

試験|しけん|名、他sa|2|考试；试验
試験問題|しけんもんだい|名|4|试题
聴解|ちょうかい|名|0|听解
文字|もじ|名|1|文字
語彙|ごい|名|1|词汇
読解|どっかい|名、他sa|0|阅读理解文章
文法|ぶんぽう|名|0|语法
セクション|せくしょん|名|1|项目、部分（section）
それぞれ|それぞれ|副|23|分别、各个
大きな|おおきな|连体|1|大的
問題|もんだい|名|0|试题；问题
小さな|ちいさな|连体|1|小的
選択肢|せんたくし|名|43|选项、选择分支
正しい|ただしい|形|3|正确的
答え|こたえ|名|2|回答、答复
選ぶ|えらぶ|他五|2|选择
書き間違う|かきまちがう|他五|5|写错
書き直す|かきなおす|他五|04|重写
消しゴム|けしごむ|名|0|橡皮
消す|けす|他五|0|擦掉、抹掉；去掉；关（灯等）
開始|かいし|名、他sa|0|开始
ベル|べる|名|1|电铃（bell）
鳴る|なる|自五|0|响、鸣
このよう|このよう|形动|3|这样的、如此的
説明|せつめい|名、他sa|0|说明
厳しい|きびしい|形|3|严厉的；很甚的
一生懸命|いっしょうげんめい|形动、副|5|拼命
頑張る|がんばる|自五|3|努力
予鈴|よれい|名|0|预备铃
席|せき|名|1|座位
問題用紙|もんだいようし|名|5|问题卷
解答用紙|かいとうようし|名|5|答卷
配る|くばる|他五|2|分发、分配
すぐ|すぐ|副|1|马上；（距离）很近
書き始める|かきはじめる|他一|50|开始写
始める|はじめる|他一|0|开始
合図|あいず|名、自他sa|信号
開ける|あける|他一|0|打开
注意事項|ちゅういじこう|名|4|注意事项
言う|いう|他五|0|说
名前|なまえ|名|0|名字
必ず|かならず|副|0|一定
鉛筆|えんぴつ|名|0|铅笔
使う|つかう|他五|0|用、使用
・・・中|ちゅう|接尾|-|在...中；正在...中
話|はなし|名|3|说话；话；故事
教科書|きょうかしょ|名|3|教科书
カンニング|かんにんぐ|名、自sa|作弊（cunning）
資格|しかく|名|0|资格
取り消す|とりけす|他五|03|取消
質問|しつもん|名、自他sa|0|提问、询问
答える|こたえる|自一|32|回答
・・・方|かた|接尾|-|表示方法
教える|おしえる|他一|0|教
すべて|すべて|副|1|全部、一切
つける|つける|他一|2|划（圈）；搽、涂抹
解答欄|かいとうらん|名|3|回答栏
出す|だす|他五|1|交、拿出、提出
持ち帰る|もちかえる|他五|03|拿回、带回
採点|さいてん|名、他sa|0|打分、评分
ボールペン|ぼうるぺん|名|0|圆珠笔
途中|とちゅう|名|0|中途
印刷|いんさつ|名、他sa|0|印刷
上げる|あげる|他一|0|举、扬；提高
メモを取る|めもをとる|组|-|做笔记
規定|きてい|名、他sa|0|规定
考える|かんがえる|他一|4|考虑；思维
答案|とうあん|名|0|答案
汚い|きたない|形|3|不干净、肮脏
結果|けっか|名|0|结果
コンピューター|こんぴゅうたあ|名|3|计算机（computer）
統計|とうけい|名、他sa|0|统计
気をつける|きをつける|组|-|注意
延ばす|のばす|他五|2|伸展；延长；推迟
守る|まもる|他五|2|遵守



読解文

訪問のマナー

人を訪問する時、予め電話で日時を約束してなくではいけません。そして、約束した時間より早く行ってはいけません。必ず約束の時間に行ってください。家を入る時は、ベルやチャイムを鳴らしてください。勝手にドワを開けてはいけません。手土産は部屋に入って渡してください。その時はこう言います。
「ささやかですが、どうぞお受け取りください。」
でも、花や生鮮食品は部屋に入る前に渡してください。訪問先で食事をする時は、嫌いなものは無理に食べなくてもいいです。帰る時はお礼を言ってください。
「今日は本当にありがとうございました。」
次に会った時も必ずお礼を言ってください。
「先日はどうもありがとうございました。」

単語

訪問|ほうもん|名、他sa|0|访问
マナー|まなあ|名|1|礼节、仪态（manners）
予め|あらかじめ|副|0|预先
日時|にちじ|名|12|日期和时间
約束|やくそく|名、他sa|0|约定
早い|はやい|形|2|早
入る|はいる|自五|1|进入；加入；到手
チャイム|ちゃいむ|名|1|门铃（chime）
鳴らす|ならす|他五|0|鸣、啼、使出声
勝手|かって|形动|0|任意、随便
手みやげ|てみやげ|名|2|随手携带的礼物、简单礼品
渡す|わたす|他五|0|交、给
こう|こう|副|10|如此、这样
細やか|ささやか|形动|2|一些、微薄的
お受け取りください|おうけとりください|组|-|请收下
生鮮食品|せいせんしょくひん|名|5|生鲜食品
訪問先|ほうもんさき|名|0|访问地
無理|むり|形动、名、自sa|1|强行；勉强
礼|れい|名|1|礼仪、谢意
次に|つぎに|副|2|接着；下一次
先日|せんじつ|名|0|前几天、日前、上次
