第十七課 元旦

前文

あさっては元旦です。この日には新年を祝う特別公演があります。李さんは公演を見に行きたいと思っています。魯さんは、李さんが行けば自分も行こうと思っています。留学生の竹内さんは用事がなければ行くと言っていました。そして、李さんはもう一度う携帯電話で竹内さんを誘って見ようと思っていました。
文化劇場までは、まず十八番のバスに乗って、それから、地下鉄に乗り換えればいいのですが、元旦は大変な人出で、バスがとても込むので、李さんたちは自転車で行こうと考えました。魯さんは留学生の安全を心配していますが、李さんは交通規則を守れば大丈夫だと言いました。ただ、当日の天気が心配です。そこで、李さんはあさっての天気予報を聞いてみようと思いました。

会話

李：魯さん、あさって、文化劇場で特別公演があるの知っていますか。
魯：ああ、元旦を祝う特別公演ですね。今朝、王さんから聞きました。出し物はおもしろいでしょうか。
李：おもしろいだろうと思います。
魯：どんな出し物があるのでしょうか。
李：歌は合唱と独唱があります。
魯：踊りは何がありますか。
李：バレエと民族舞踊があります。
魯：芝居は。
李：京劇や地方劇などがあります。そのほかに、曲芸、漫才、コントなどもありますよ。
魯：そうですか、何でもありますね。漫才は私大好きです。李さんは見に行きますか。
李：ええ、行くつもりです。魯さんは。
魯：もし、あなたが行けば私も行きますが、あなたが行けなければ、私も行きません。
李：じゃ、一緒に行きましょう。王さんは用事がなければ行くと言っていました。
魯：そうですか。留学生の石川さんはどうですか。
李：誘えば行くだろうと思います。
魯：竹内さんは。
李：竹内さんも用事がなければ行くと言っていました。
魯：そうですか。竹内さんも一緒に行きことができればいいですね。
李：じゃ、携帯電話でもう一度誘ってみましょう。ところで、文化劇場まで何で行けばいいでしょうか。
魯：まず、十八番バスに乗って、それから、地下鉄を乗り換えればいいですが、元旦は大変な人出て、バスがきっと込むでしょう。
李：じゃ、自転車で行く方がいいでしょう。
魯：しかし、石川さんと竹内さんは自転車で大丈夫でしょう。
李：大丈夫でしょう。交通信号は中国も日本も同じで、赤は「止まれ」、黄色は「注意しろ」、青は「進め」ですから、規則を守ればいいでしょう。
魯：そうですか。じゃ、あさっては何時に出発すればいいですか。
李：元旦ですから、早ければ早いほどいいです。
魯：八時に出発すれば間に合いますか。
李：八時に出発すれば間に合うと思います。
魯：あさって、どこで持ち合わせましょうか。
李：大学の広場でどうですか。
魯：いいですね。しかし、当日雨が降ればどうしましょうか。
李：雨がひどく降れば行ってもおもしろくないからやめましょう。
魯：少しぐらい天気が悪くても行きますか。
李：少しぐらい天気が悪くても行くつもりです。
魯：あさって天気が良ければいいですね。
李：ええ、今晩、あさっての天気予報を聞いてみましょう。

単語

元旦|がんたん|名|0|元旦
新年|しんねｎ|名|1|新年
祝う|いわう|他五|2|庆祝、祝贺
公演|こうえん|名|0|公演
竹内|たけうち|专|2|竹内（姓）
用事|ようじ|名|0|（必须办的）事情
もう|もう|副|01|再、另外
携帯電話|けいたいでんわ|名|5|手机
誘う|さそう|他五|0|邀请；诱惑
劇場|げきじょう|名|0|剧场
番|ばん|接尾|-|几路，几号
乗り換える|のりかえる|他一|43|改乘、换乘
安全|あんぜん|名、形动|0|安全
心配|しんぱい|名、形动、他sa|0|担心
規則|きそく|名|12|规则、规章
大丈夫|だいじょうぶ|形动、副|不要紧、没问题
当日|とうじつ|名|0|当天
そこで|そこで|接|0|于是；那么
天気予報|てんきよほう|名|4|天气预报
今朝|けさ|名|1|今天早晨
出し物|だしもの|名|23|演出节目
合唱|がっしょう|名、他sa|0|齐唱、合唱
独唱|どくしょう|名、他sa|独唱
バレエ|ばれえ|名|1|芭蕾舞（法：ballet）
民族舞踊|みんぞくぶよう|名|5|民族舞蹈
芝居|しばい|名|0|戏剧
京劇|きょうげき|名|0|京剧
地方劇|ちほうげき|名|2|地方戏
曲芸|きょくげい|名|02|杂技
漫才|まんざい|名|3|（对口）相声
コント|こんと|名|1|小品（法：counte）
もし|もし|副|1|如果、万一
石川|いしかわ|专|0|石川（姓）
きっと|きっと|副|0|一定
信号|しんごう|名|0|信号
赤|あか|名|1|红色
止まる|とまる|自五|0|停下；堵塞；止住
黄色|きいろ|名|0|黄色
注意|ちゅうい|名、自sa|当心；提醒
青|あお|名|1|绿灯；青、蓝
進む|すすむ|自五|0|前进；进步；（钟表）快
出発|しゅっぱつ|名、自sa|0|出发
間に合う|まにあう|自五|3|赶得上、来得及
待ち合わせる|まちあわせる|他一|50|在约定的场所等待（见面）
酷い|ひどい|形|2|厉害的；无情的
止める|やめる|他一|0|作罢、停止；辞职
今晩|こんばん|名|1|今晚


読解文

日本のお正月

日本のお正月は三日間から一週間ぐらい学校や会社、店などが休みになります。多くの人がこの休みを利用して旅行するか、あるいはふるさとへ帰ります。年末に人と最後の別れる時に良いお年をと言って別れます。
大晦日に、年越しそばを食べる習慣があります。これは長生きを祈るという意味です。夜十二時から除夜の鐘が鳴ります。みんなは鐘の音に耳を傾けながら過ぎて行く年を思います。また大晦日にテレビの特別番組（紅白歌合戦など）を楽しむ人も多いです。
一眠りすればもう元日の朝です。郵便屋さんが年賀状を配達してきます。合う人に「明けましておめでとうございます、今年もよろしくお願いします」と言って新年の挨拶をします。元旦の朝はお雑煮やおせち料理を食べます。それから、初詣でに行きます。近くにお寺や神社に詣でて、向こう一年間の家族の健康と幸福を祈ります。

単語

休み|やすみ|名|3|休息；休假
多く|おおく|名、副|1|许多；多半、大都
故郷、故里|ふるさと|名|2|故乡
年末|ねんまつ|名|0|年末、年底
最後|さいご|名|1|最后
大晦日|おおみそか|名|3|大年三十
年越し蕎麦|としこしそば|名|5|除夕吃的荞麦面
長生き|ながいき|名、自sa|43|长命、长寿
除夜|じょや|名|1|除夕
鐘|かね|名|0|钟；钟声
音|ね|名|0|（钟）声；音色
耳を傾ける|みみをかたむける|组|-|倾听
過ぎる|すぎる|自一|2|时间流逝；经过；过度
紅白|こうはく|名|1|红白
歌合戦|うたがっせん|名|3|对歌比赛
一眠り|ひとねむり|名、自sa|打个盹、睡一会
元日|がんじつ|名|0|元月一日
郵便屋|ゆうびんや|名|0|邮递员
年賀状|ねんがじょう|名|30|贺年片
配達|はいたつ|名、他sa|0|投递、递送
明けましておめでとうございます|あけましておめでとうございます|寒暄|-|恭贺新禧、新年好
おせち料理|おせらりょうり|名|4|过年吃的菜肴
初詣で|はつもうで|名|3|新年首次参拜
詣でる|もうでる|自一|3|参拜
向こう|むこう|名|02|从今以后、今后
健康|けんこう|名、形动|0|健康
幸福|こうふく|名、形动|0|幸福
